3 2 0 0 0 0 1 3 3 3 5 3 3 3 3 3 3 3 5 4 4 4 3 3 3 3 2 1 3 3 /
3 1 0 0 0 0 1 2 3 3 3 3 2 0 0 0 1 3 4 5 3 3 2 0 2 2 1 1 3 3 /
3 3 0 0 0 0 1 2 3 3 3 1 3 1 0 0 0 2 3 5 3 3 0 0 0 1 0 1 1 3 /
3 3 2 2 2 1 1 1 3 3 3 3 3 3 2 1 0 0 2 3 3 2 0 0 0 0 1 1 1 1 /
5 3 4 4 3 3 3 3 3 3 4 3 3 4 3 2 2 0 0 3 3 2 3 0 0 0 0 1 1 1 /
5 4 5 6 5 5 3 3 3 3 3 5 5 4 3 3 3 1 0 2 3 3 3 2 2 0 0 0 2 3 /
3 3 6 6 6 6 3 3 2 3 3 3 3 4 3 3 3 3 2 2 2 3 3 3 2 0 0 0 2 3 /
3 3 6 6 6 3 3 3 3 3 4 3 3 3 3 4 3 3 3 3 3 3 3 3 0 0 0 2 3 3 /
3 3 4 4 3 4 3 3 4 3 3 3 3 3 2 1 2 3 3 2 2 3 3 3 3 1 3 3 3 3 /
3 5 4 3 3 3 3 3 3 3 4 4 3 3 0 0 1 3 3 3 3 3 3 3 3 3 3 3 3 3 /
3 5 5 4 5 3 1 1 3 3 3 3 3 3 1 1 1 3 3 3 3 4 4 3 5 3 3 4 5 4 /
3 4 5 5 3 3 2 3 3 3 3 3 3 2 1 1 1 3 3 3 3 6 6 5 5 5 4 4 4 4 /
3 4 4 3 3 3 3 3 3 4 3 3 3 3 3 3 3 3 3 3 3 5 6 6 5 5 5 3 3 3 /
3 3 3 3 3 3 2 3 3 4 3 3 3 3 3 3 3 1 2 1 2 3 5 4 5 5 3 3 3 3 /
3 2 2 3 2 2 2 3 3 3 3 3 3 3 3 3 3 3 1 0 1 3 3 4 3 4 5 5 3 3 /
3 2 2 3 3 1 3 3 3 3 3 3 3 3 3 3 2 2 2 0 0 1 3 3 5 3 5 5 3 3 /
3 1 3 3 3 3 3 2 3 3 3 3 3 3 3 3 3 3 3 1 0 1 3 3 5 4 5 5 3 1 /
1 0 0 1 0 1 0 2 1 1 1 0 1 1 1 2 3 3 1 3 3 3 3 4 3 3 3 3 2 0 /
0 0 0 0 0 0 0 0 1 1 0 1 1 0 0 0 1 1 1 1 1 3 3 3 2 2 2 1 1 0 /
0 0 0 0 0 0 0 1 0 1 0 1 3 1 0 0 3 2 1 0 0 1 2 3 0 1 1 0 0 0 /
0 0 0 0 0 0 0 0 1 1 2 3 3 2 0 1 3 3 1 1 0 2 3 2 2 3 1 1 0 0 /
1 0 0 0 0 0 0 0 1 3 3 3 4 3 2 3 3 1 1 1 1 3 3 3 3 3 1 1 1 1 /
2 1 0 0 0 0 0 0 3 3 4 5 4 5 3 3 3 3 3 3 3 3 3 3 3 2 1 0 1 2 /
3 3 3 2 2 3 3 3 6 6 6 6 5 5 5 3 3 3 4 4 3 1 2 2 1 0 0 0 1 3 /
4 3 3 3 3 3 3 5 6 6 6 6 6 5 5 3 3 5 6 3 3 3 2 1 0 0 0 0 0 3 /
3 3 3 3 5 5 5 5 6 6 6 6 6 5 4 3 3 4 5 3 3 4 3 1 0 0 0 0 2 3 /
5 4 3 3 3 3 3 4 5 6 6 6 5 5 4 3 5 4 3 3 4 5 3 3 2 2 2 3 3 4 /
6 5 3 1 2 1 1 3 3 6 6 6 6 5 5 4 4 3 5 5 5 5 3 3 3 3 5 3 3 4 /
6 6 4 3 2 0 1 1 5 6 6 6 6 6 6 5 5 3 3 4 4 3 4 3 3 5 5 4 5 4 /
4 4 4 3 3 1 1 0 5 5 5 5 6 6 6 3 4 4 3 3 3 3 3 3 4 3 5 5 4 3 /
