30 30
>0 deep_ocean
>1 shallow_ocean
>2 plain
>3 forest
>4 hill
>5 mountain
0 0 0 0 0 1 0 1 1 1 1 0 0 0 0 1 0 1 0 0 0 0 0 0 0 0 0 0 1 0 1 1 0 1 0 0 0 0 0 0 0 0 0 0 0 0 0 0 0 0 / 
0 0 0 0 1 1 2 1 2 2 1 0 0 1 1 1 2 1 0 0 0 1 0 1 0 1 1 1 1 2 1 1 2 1 1 1 1 1 1 1 1 1 0 0 0 0 0 0 0 0 / 
0 0 0 0 1 2 1 1 1 1 1 0 0 1 2 2 1 1 0 0 0 1 2 1 1 1 2 2 2 2 2 2 2 3 2 2 2 1 2 2 2 1 1 1 1 0 0 0 0 0 / 
0 0 0 1 1 1 1 2 2 1 1 1 1 1 2 1 1 1 1 1 1 1 2 2 2 2 3 2 2 2 2 2 2 2 1 2 2 2 2 2 2 2 2 2 1 0 0 0 0 0 / 
0 0 0 1 2 2 3 1 2 2 1 2 3 2 1 1 1 2 2 2 1 1 1 2 2 2 3 3 3 3 2 1 2 3 2 2 2 2 2 2 3 3 2 1 1 0 0 0 0 0 / 
0 1 1 1 2 1 1 1 1 2 1 2 2 1 1 1 1 2 2 1 2 2 2 2 1 1 2 2 2 2 2 2 1 2 2 3 2 3 2 3 3 3 2 1 1 0 0 0 0 0 / 
1 1 2 3 2 1 2 3 2 1 2 2 2 2 2 1 1 2 1 1 2 2 2 2 2 1 2 2 2 2 2 1 1 2 2 3 2 2 2 3 3 3 3 2 1 1 1 0 0 0 / 
1 2 2 2 2 2 1 1 2 2 2 1 2 2 3 2 2 2 2 1 2 2 2 2 1 2 1 1 2 2 2 2 2 1 2 2 2 2 2 3 2 2 2 2 2 2 1 0 0 0 / 
1 1 2 3 3 2 2 2 2 2 2 2 2 2 2 3 3 3 2 2 2 1 2 2 2 2 1 2 2 2 2 2 1 2 1 3 3 2 3 2 2 2 2 3 2 2 1 1 0 0 / 
0 1 1 2 3 3 2 3 3 3 3 3 2 3 2 3 3 2 1 2 2 2 2 1 3 2 2 3 3 3 2 1 1 2 1 1 2 2 2 1 1 2 2 2 2 2 2 1 0 0 / 
0 0 1 2 2 2 2 3 4 3 3 3 2 2 2 2 2 2 2 2 2 2 2 2 2 3 3 4 3 2 1 1 2 2 2 2 2 3 3 2 2 2 1 2 2 2 1 1 0 0 / 
0 1 1 2 2 2 2 2 2 3 3 3 1 3 3 2 3 2 2 3 2 2 2 2 2 2 2 2 2 2 2 2 2 2 2 2 3 2 2 2 2 2 2 2 2 2 2 1 1 0 / 
1 1 2 3 2 2 1 1 1 2 2 2 2 3 5 3 3 2 2 2 2 3 2 2 3 2 2 2 2 2 2 3 2 2 2 2 3 3 2 3 3 2 2 2 2 2 3 2 1 0 / 
1 2 2 2 3 2 1 1 1 2 3 3 3 3 3 3 3 2 2 2 2 2 1 1 3 2 3 2 1 2 1 2 3 2 3 2 2 2 2 2 1 1 2 3 2 2 2 1 1 1 / 
1 2 2 2 2 2 2 2 1 2 3 3 4 2 2 2 2 2 2 2 1 2 2 3 2 2 2 2 2 1 2 2 3 2 3 2 2 2 2 2 2 2 2 4 2 2 2 2 2 2 / 
1 1 2 2 2 2 3 3 2 2 2 2 3 3 3 3 3 2 3 2 2 2 2 1 2 2 1 2 1 1 2 2 3 3 2 2 2 3 3 3 2 2 2 2 2 2 2 1 2 1 / 
0 1 2 2 3 3 2 2 2 3 2 2 2 2 2 2 2 2 3 2 2 2 2 2 2 2 2 2 2 2 2 2 2 2 2 2 2 2 3 2 2 1 2 1 1 1 1 1 2 1 / 
0 1 2 2 3 3 2 2 3 1 2 2 3 2 1 2 2 2 2 3 2 2 3 2 2 2 2 2 3 1 2 2 2 3 2 2 1 2 2 1 1 2 1 1 0 0 0 1 0 1 / 
0 1 2 1 2 5 5 3 3 1 2 3 2 2 2 3 3 2 2 2 2 3 3 2 2 2 3 3 2 3 2 1 1 2 2 1 1 1 2 1 1 0 1 0 0 0 0 0 0 0 / 
1 1 1 2 3 4 4 2 2 2 3 3 2 2 3 4 4 3 3 2 3 3 3 3 2 2 3 3 2 2 2 2 1 2 2 2 1 3 1 1 0 0 0 0 0 0 0 0 0 0 / 
1 2 2 3 3 1 3 3 3 3 2 2 2 2 3 3 2 2 2 3 3 3 3 2 2 2 2 3 2 2 2 2 2 1 1 1 2 2 2 1 0 0 0 0 0 0 0 0 0 0 / 
1 1 2 2 1 2 3 3 2 2 3 2 2 2 2 2 2 2 2 2 3 2 2 2 2 2 2 2 3 2 2 2 1 1 0 1 1 2 2 1 0 0 0 0 0 0 0 0 0 0 / 
0 1 1 2 1 1 2 2 2 3 3 2 1 1 2 2 1 1 1 1 2 2 3 2 2 2 3 3 3 1 1 1 1 0 0 0 1 2 1 1 0 0 0 0 0 0 0 0 0 0 / 
1 1 2 2 2 2 2 3 2 3 2 1 1 1 1 2 1 0 0 1 2 1 1 2 3 3 1 2 1 1 0 0 0 0 0 0 1 0 1 0 0 0 0 0 0 0 0 0 0 0 / 
1 2 2 2 1 1 2 3 3 2 1 2 1 1 1 0 1 0 0 1 0 1 1 1 2 2 3 2 1 1 1 0 0 0 0 0 0 0 0 1 0 1 0 0 0 0 0 0 0 0 / 
1 1 1 1 1 2 2 2 3 3 2 1 2 2 1 1 0 0 0 0 0 1 2 1 1 2 2 2 2 2 1 1 1 0 0 0 0 1 0 1 2 1 1 0 0 0 0 0 0 0 / 
0 0 0 0 1 3 2 2 3 2 2 2 2 1 2 1 1 1 1 1 0 1 2 2 2 1 3 3 1 2 2 2 1 0 0 0 0 1 2 1 1 2 1 0 0 0 0 0 0 0 / 
0 0 0 0 1 1 1 3 2 2 1 1 1 2 2 1 2 2 2 1 1 1 1 1 2 3 3 2 2 2 2 1 1 1 1 1 1 1 2 1 1 1 1 1 0 0 0 1 1 1 / 
0 0 1 0 1 1 2 2 1 2 1 0 1 1 1 2 2 1 2 2 1 1 0 1 2 3 2 1 2 2 3 2 2 1 2 2 2 1 1 1 1 1 2 1 0 0 1 1 2 2 / 
0 0 1 2 1 1 1 1 1 1 1 0 1 2 2 1 1 2 2 2 2 1 1 1 3 2 1 1 1 3 2 2 1 1 2 1 2 1 2 2 1 2 2 1 0 0 1 2 2 2 / 
1 1 1 2 2 1 2 3 2 3 1 0 1 1 2 2 2 1 2 2 2 2 1 2 2 1 2 2 2 2 2 2 2 3 2 2 2 1 2 1 1 2 2 1 1 1 1 2 2 2 / 
1 2 2 2 2 2 3 2 2 2 1 0 1 1 2 2 2 2 1 3 2 2 2 2 1 2 3 2 2 2 2 2 2 3 3 3 2 1 0 1 1 1 2 1 1 2 2 2 2 2 / 
1 2 1 2 2 3 3 2 2 2 1 1 1 2 1 2 2 3 2 3 3 2 2 2 2 2 2 2 2 2 1 2 3 2 2 2 2 1 1 0 0 1 2 1 1 2 2 1 1 1 / 
1 1 2 2 2 4 3 2 2 2 2 1 2 1 2 2 2 3 3 2 2 2 3 2 3 1 1 2 1 2 2 2 2 2 2 2 2 2 1 0 0 1 0 1 1 2 2 1 2 1 / 
0 1 1 3 2 2 2 2 2 2 1 2 2 1 1 2 3 2 2 1 2 2 2 2 2 2 1 2 1 2 1 2 1 2 1 2 1 1 1 0 0 0 0 0 1 1 1 1 2 1 / 
0 0 1 2 2 2 1 1 1 1 1 1 2 3 2 2 3 2 2 2 3 1 1 2 1 2 2 1 2 2 2 2 2 1 2 1 1 0 0 0 0 0 0 0 0 0 0 1 0 1 / 
0 0 1 1 2 2 2 2 2 1 2 2 3 3 3 3 2 2 1 2 2 3 2 2 1 2 2 2 3 3 2 2 1 1 0 1 0 0 0 0 0 0 0 0 0 0 0 0 0 0 / 
0 0 0 1 1 1 1 1 2 1 2 2 2 3 3 3 3 2 1 3 2 1 1 2 2 2 1 1 2 3 3 2 1 1 0 0 0 0 0 0 0 0 0 0 0 0 0 0 0 0 / 
0 0 0 0 0 0 0 1 2 2 1 1 2 2 3 3 2 2 1 1 3 2 1 2 2 2 1 2 2 3 3 2 2 1 0 0 0 0 0 0 0 0 0 0 0 0 0 0 0 0 / 
0 0 0 0 0 0 0 1 1 1 1 1 2 1 2 2 2 1 2 1 2 1 1 2 2 2 1 2 2 2 2 1 1 1 1 1 1 0 0 0 0 0 0 0 0 0 0 0 0 0 / 
0 0 0 0 0 0 0 0 0 0 1 2 2 2 1 2 2 2 1 1 1 1 2 2 1 2 1 2 2 2 2 2 2 1 2 2 1 0 0 0 0 0 0 0 0 0 0 0 0 0 / 
0 0 0 0 0 0 0 0 0 0 1 2 1 1 1 1 2 2 2 2 2 1 1 1 1 1 2 2 1 2 2 3 3 3 2 1 1 0 0 0 0 0 0 0 0 0 0 0 0 0 / 
0 0 0 0 0 0 0 0 0 0 1 2 1 1 1 2 1 1 1 2 1 1 1 2 1 2 2 2 2 2 3 3 3 2 2 2 1 0 0 0 0 0 0 0 0 0 0 0 0 0 / 
0 0 0 0 0 0 0 0 1 1 1 2 2 1 1 2 1 1 1 1 2 1 1 2 2 2 1 2 3 3 3 4 4 3 2 1 1 0 0 0 1 1 1 1 0 0 0 0 0 0 / 
0 0 0 0 0 0 0 1 1 2 2 2 2 1 1 1 1 1 2 2 1 1 1 1 1 1 2 2 3 3 2 3 3 3 2 1 1 0 0 1 1 2 2 1 1 0 0 0 0 0 / 
0 0 0 0 0 0 0 1 2 2 2 2 2 2 1 1 2 2 1 1 1 0 0 1 2 2 2 2 2 2 1 2 2 2 1 2 1 1 1 1 2 1 2 3 1 0 0 0 0 0 / 
0 0 0 0 0 0 0 1 2 3 3 2 2 2 2 2 1 1 1 1 0 0 0 1 1 1 1 2 1 3 1 2 2 3 2 1 2 2 1 2 1 2 2 2 1 0 0 0 0 0 / 
0 0 0 0 0 1 0 1 2 1 1 3 2 2 2 2 2 1 2 1 0 0 0 0 0 0 1 1 2 2 2 2 2 3 2 3 2 1 2 2 2 2 2 2 1 0 0 0 0 0 / 
0 0 0 0 0 1 2 1 2 1 1 1 1 1 2 1 2 1 2 1 0 0 0 0 0 0 0 1 1 2 2 2 2 2 2 2 1 1 2 1 1 1 1 2 1 1 0 0 0 0 / 
0 0 0 0 0 1 2 1 0 1 1 2 1 2 2 2 1 1 2 1 0 0 0 0 0 0 0 0 1 2 1 1 1 2 1 1 2 1 2 1 0 0 1 1 2 1 0 0 0 0 / 
